verb + ed
i wanted to help you
we worked very hard
you helped me a lot
they looked at her

he called her again
she really liked this place
it seemed so interesting 

almost - парктически
get in touch - связаться
a couple of question - пара вопросов
listen to music - слушать музыку
turn - повернуть
smile(at) - улыбнуться
includ - включить
turn on - включить
turn off - выключить
switch on/off  - включить/выключить
light - свет
revise - повторять
went - поехать
walk - пойти пешком
move - переходить, перейти
provide - предоставлять, обеспечивать
consider - считать
wait for - ждать кого-то
enter - входить 
prestigious - престижный
die - умирать
expect - ожидать
stay - остаться
the day before yesterday - позавчера
reach - достичь
strong - сильный
appear - появляться
disappear - исчезать
suddenly - вдруг
unexpectedly - неожиданно
suggest - предложить
remain - остаться
calm - спокойно
came back - вернулся
clearly - понятно
ability - способность
develop - развивать
skill - навык
require - требовать
effort - усилие
decide - решать
recieve - получить

face - столкнуться
describe - описать
appearance - внешность
partly - частично
the following - следующий
opportunity - возможность
miss - упустить, скучать
guess - угадать
sound - звучать

imagine - воображать
knock at the door - постучать в дверь
knock - постучать
considerably - значитеольно
significantly - значительно
good luck - удача
wish - пожелать
all the best - всего самого наилучшего
achieved - достичь
introduce - представить

fence - забор
fill in - заполнять
deliver - доставить
accuse - обвинять
accusation - обвинение
waste - тратить в пустую
destroy - разрушить
invite - пригласить
promise - обещать



speech - речь
tend - склонно
about an hour - около часа
half an hour - пол часа
rarely - редко
seldom - редко
inspire - вдохновить
attract - привликать
influence - повлиять
from time to time
apologize - извиниться
repaire - починить


surprise - удивить
admire - восхищаться
cross - пересекать
hurry up - поторопиться
compete - конкурировать
manage - суметь, управлять
by mistake - по ошибке
deserve - заслужить
confirm - подтвердить
trust - доверять
completely - полностью
focus - фокусироваться
concentrate - концентрироваться
topic - тема
issue - вопрос
resolve - разрешить
celebrate - праздновать
experience - опыт, испытать
borrow - занять
interrupt - перебивать
conversation - разговор
several - несколько


report- отчет
calculate - расчитать
discover - открыть
divide - разделять
wash - мыть
hand - рука
wash up the dishes - помыть посуду 
confuse - путать
mix up - путать
own - владеть
pack - упаковать
clothes - одежда
parcel - посылка
not far from here - не далеко от сюда
pray - молиться
saint - святой
crime - преступление
arrest - арестовать
accident - проишествие
participate - принять участие
take part - принять участие
thief - вор
react - реагировать


suspicious - подозрительно
innocent - невинный
during - 
immediately - сразу же
at once - сразу же
guilt - вина
defend - защищать
well-known - известный
anniversary - годовщина




1. have - had - had

have a good time - хорошо провести время
have a great time - прекрасно провести время

2. do - did - done
i did it on time
do someone a favor - делать кому-то одолжение
He did me a favor - он делал мне одолжение


3. make - made - made
He made a discovery
discovery - открытие

4. be - was/were - been

I/He/She/It - was
We/You/They - were


5. go - went - gone

I went to work
He went to school


6. can - could
I could learn English for hours


7. get - got - got 
He got 2000 dollars a month/ monthly


postpone / put off - откладывать

8. know - knew - known

we knew it in the beginning


9. say - said - said

He said it ver quietly
quietly - тихо
loudly - громко


10. tell - told - told
he told me everything
she told me this thing
instead of - вместо кого-то



11.speak - spoke - spoken

12.take - took - taken

13.see - saw - seen

for the first time - первый раз

14. come - came - come 

15.think - thought - thought


differently - по другому

16.feel - felt - felt

17.become - became - become

18. put - put - put - класть, вставить


19. find - found - found

wallet - бумажник

find out - выяснять, обнаружить

20. give - gave - given 

give up - бросать

He gave up smoking/ drinking bear


upset - расстроен

21. cost - cost - cost 

22. mean - meant - meant - означать, намеряться

23. begin - began - begun


24. show - showed - shown - показать

outstanding - выдающийся



25. let - let - let - позволять

let somebody do something

26. leave - left - left - уходить
i left Russia
we left England

leave for - пойти куда то

left for = go to
I left for Russia
We left for America


26. hear - heard - heard - услышать

I heard it on the radio
I heard it in the news

28. run - ran - run -  бежать


She ran very slowly
Her ran away - Он убежал


29. bring - brought - brought - приносить

30. write - wrote - written - написать

write down
I wrote it down
I wrote down this word
I wrote this word down


31. read - read -read

32. sit - sat - sat
I sat on a chair
I sat in an armchair
I sat down

32. stand - stood - stood

I stood up

behind - сзади

34. lose - lost - lost - терять
She lost her bag

35. pay - paid - paid

I paid for her
service - услуга

36. meet - met - met

They met at last
classmate - одноклассник

37. set - set - set - устанавливать, поставить

He set it on the table
He set a glass of water on the table

set up - основать

38. learn - learnt - learnt 

by heart - наизусть

understand - understood - understood 

40. cut - cut - cut - порезать

He cut himself
She cut herself
she cut the meat
He cut the meat into four  parts/ pieces



41. sell - sold - sold - продавать

country house - загородный дом

42. spend - spent - spent - тратить, проводить


43. grow - grew - grown - выращать, расти

garden - сад

i grew up in America



44. win - won - won - выиграть


45. buy - bought - bought - купить

notification - уведомление


46. send - sent - sent -  отправить



47. fall - fell - fallen  - упасть
He fell on the ground
ground - земля
arm - рука
fall down - упасть на землю

48. keep - kept - kept - хранить

49. hurt - hurt - hurt - ушибить


50. hold - held - held - держать

I held it in my arms
I held her bag


51. break - broke - broken - ломать


The broke the window

breake down  - ломаться

His car broke down 

properly - правильно
spacious - просторный


51. catch - caught - caught - ловить

52. draw - drew - drawn

masterpiece - шедевр


53. fight - fought - fought - драться

bravely - смело
courageously - отважно
independence - независимость


54. deal - dealt - dealt - иметь дело

supplier - поставщик
сomplaint - жалоба


55. throw - threw - thrown - бросать

stone - камень


56. wear - wore - worn - носить одежду

fashionable / stylish 

belt - ремень



57. teach - taught - taught - преподавать

58. lie - lay - lain - лежать 

i lay down
i lay in bed


59. lay - laid - laid - класть , поставить

60. fly - flew - flown - летать

I flew to America

i flew back to Los Angeles




61. sing - sang - sung

62. sleep - slept - slept 

63.forget - forgot - forgotten 

64. hit - hit - hit 

65. eat -ate - eaten

66. drink - drank - drunk 

glass of water - стакан воды

pie - пирог
a piece of cake - кусочек торта



67. hid - hid - hidden - прятаться

tree - дерево
camel - верблюд

68. ride - rode - ridden - кататся

I rode a horse - я катался на лошади


69. feed - fed - fed - кормить


70. fit - fit - fit - подходить 

These shoes fit me

shoes - обувь


71. overcome - overcame - overcome - преодалевать

72. swim - swam - swum 

swimming pool - бассейн

lake - озеро
sea - море
ocean - океан



73. lend - lent - lent  - одолживать


74. blow - blew - blown - дуть

The wind blew suddenly


75. hurt - hurt - hurt - повредить, ушибить

She hurt her arm


76. dream - dreamt - dream - мечтать
(dream - dreamed - dreamed)


77. steal - stole - stolen - украсть

jewelry - ювелирное украшение


78. wake - woke - woken - просыпаться

wake up


79. dig - dug - dug - копать


he dug a hole

hole - яма


80. forgive - forgave - forgiven - прощать

I forgave her



81. drive - drove - driven - вводить машину


82. hang - hung - hung - вешать


coat - пальто
hook - кручек
jacket - куртка пиджак 



83. burn - burnt - burnt - зжигать

  
84. shoot - shot -shot - стрелять


85.sink - sank - sunk - тонуть

ship - корабль
boat - лодка

drown - тонуть (человек)


86. rise - rose - risen - подниматься, встать

per cent - 


87. ring  - rang - rung - звенеть

bell - звонок


88. spoil - spoilt - spoilt - испортить 



89. smell - smelt - smelt - пахнуть


90. withdraw - withdrew - withdrawn - снять деньги


terrible  - ужасно
awful - ужасно



91. misunderstand - misunderstood - misunderstood - неправильно понять
92. underpay - underpaid - underpaid - недоплатить
93. overpay - overpaid - overpaid - переплачивать
94. tear - tore - torn - рвать
95. redo - redid - redone - переделать
96. oversleep - overslept - overslept - проспать
97. overeat - overate - overeaten - переедать

98. light - lit - lit - зажигать

candle - свеча


99. bite - bit - bitten - кусать

100. foresee - foresaw - foreseen - предвидеть

trouble - беда



boast - похвастася
cancel - отменить
break up - растаться
intention - намерение
disturb - мешать
satisfactory - удовлетворительный
acquaintance - знакомый (экувейнтенс)
recover - поправился, выздоровил
wedding - свадьба
most of all - больше всего
defend - защищать



used - привыкший
accustomed - привыкший
exception - исключение
vacation - отпуск 
confidence - неуверенность
beach - пляж
careful - осторожно

pregnant - беременна
unlikely - мало вероятно
fault - вина
ahead - впереди
behind - сзади
hospitable - гостеприемный
trouble - беда 

unpredictable - непредсказуемый
thoughtful - задумчивый
loyal - лоялен
how long time ago - как давно



cover - покрывать
society - общество
taxes - налоги
income - доход
directly - прямо
responsibility - обязанность
agreement - соглашение
owner - собственник
prove - доказать
deep - глубокий
elections - выборы
above - высше
below - ниже
suit - подходить, примерить
timetable - расписание
schedule - график
insurance - страховка
spelling mistake - ошибка на правописания

be born - рождаться
into account/consideration - во внимание
to what extent / degree - в какой степени
state - утвердить
statement - утверждение






























































































































































































































































































